NUM_CAMARAS = 4
RANGO_VISION = 3
ANGULO_APERTURA = 60.0
[MAPA]
DIMENSIONES = 10 10
0 0 0 0 0 1 0 0 0 0
0 1 0 0 0 0 0 0 1 0
0 0 0 1 0 0 1 0 0 0
0 0 0 0 0 0 0 0 0 0
1 0 0 0 1 0 0 0 0 0
0 0 1 0 0 0 0 1 0 0
0 0 0 0 0 0 0 0 0 0
0 0 1 0 0 0 0 0 0 0
0 0 0 0 0 1 0 0 0 0
0 0 0 0 0 0 0 1 0 0