NUM_CAMARAS = 7
RANGO_VISION = 5
ANGULO_APERTURA = 90.0
[MAPA]
DIMENSIONES = 12 15
1 1 1 1 1 1 1 1 1 1 1 1 1 1 1
1 0 0 0 1 0 0 0 0 0 1 0 0 0 1
1 1 1 0 1 0 1 1 1 0 1 0 1 1 1
1 0 0 0 0 0 0 0 0 0 0 0 0 0 1
1 0 1 1 1 1 1 0 1 1 1 1 1 0 1
1 0 1 0 0 0 0 0 0 0 0 0 1 0 1
1 0 1 0 1 1 1 0 1 1 1 0 1 0 1
1 0 0 0 0 0 0 0 0 0 0 0 0 0 1
1 1 1 0 1 1 1 0 1 1 1 0 1 1 1
1 0 0 0 0 0 1 0 1 0 0 0 0 0 1
1 0 1 1 1 0 0 0 0 0 1 1 1 0 1
1 1 1 1 1 1 1 1 1 1 1 1 1 1 1